1111111111111
1001C00000001
10C0011111001
10001P00EC001
1111111111111
